#############D#
##   # ## ###M#
##            #
##   ## # # ###
#####   # #   #
### ### ##### #
#           # #
# # ###### ## #
# #    #   ####
# ######## #  #
#        # # ##
# # ####     ##
# ### ###### ##
#     ##G     #
########A######
